Detector,Profile,File,Threshold,Score,TP,TN,FP,FN,Total_Count
numentaTM,standard,artificialNoAnomaly/art_daily_no_noise.csv,0.512734098949,0.0,0,3428,0,0,3428
numentaTM,standard,artificialNoAnomaly/art_daily_perfect_square_wave.csv,0.512734098949,0.0,0,3428,0,0,3428
numentaTM,standard,artificialNoAnomaly/art_daily_small_noise.csv,0.512734098949,0.0,0,3428,0,0,3428
numentaTM,standard,artificialNoAnomaly/art_flatline.csv,0.512734098949,0.0,0,3428,0,0,3428
numentaTM,standard,artificialNoAnomaly/art_noisy.csv,0.512734098949,0.0,0,3428,0,0,3428
numentaTM,standard,artificialWithAnomaly/art_daily_flatmiddle.csv,0.512734098949,0.8571268814503882,6,3025,0,397,3428
numentaTM,standard,artificialWithAnomaly/art_daily_jumpsdown.csv,0.512734098949,0.8553262996215624,1,3025,0,402,3428
numentaTM,standard,artificialWithAnomaly/art_daily_jumpsup.csv,0.512734098949,0.8606718242697022,5,3025,0,398,3428
numentaTM,standard,artificialWithAnomaly/art_daily_nojump.csv,0.512734098949,-1.093690827631788,0,3024,1,403,3428
numentaTM,standard,artificialWithAnomaly/art_increase_spike_density.csv,0.512734098949,-1.33,0,3022,3,403,3428
numentaTM,standard,artificialWithAnomaly/art_load_balancer_spikes.csv,0.512734098949,0.845492147479458,9,3024,1,394,3428
numentaTM,standard,realAdExchange/exchange-2_cpc_results.csv,0.512734098949,-1.0,0,1218,0,163,1381
numentaTM,standard,realAdExchange/exchange-2_cpm_results.csv,0.512734098949,1.6182433060422161,3,1218,1,159,1381
numentaTM,standard,realAdExchange/exchange-3_cpc_results.csv,0.512734098949,2.5543675566580184,3,1155,0,150,1308
numentaTM,standard,realAdExchange/exchange-3_cpm_results.csv,0.512734098949,0.7521595533438323,1,1154,1,152,1308
numentaTM,standard,realAdExchange/exchange-4_cpc_results.csv,0.512734098949,0.2925385969619443,5,1228,4,160,1397
numentaTM,standard,realAdExchange/exchange-4_cpm_results.csv,0.512734098949,1.3847103626849764,6,1231,2,158,1397
numentaTM,standard,realAWSCloudwatch/ec2_cpu_utilization_24ae8d.csv,0.512734098949,0.5887849436245678,4,3015,11,398,3428
numentaTM,standard,realAWSCloudwatch/ec2_cpu_utilization_53ea38.csv,0.512734098949,1.095025016909685,6,3021,5,396,3428
numentaTM,standard,realAWSCloudwatch/ec2_cpu_utilization_5f5533.csv,0.512734098949,1.7231016041511955,6,3026,0,396,3428
numentaTM,standard,realAWSCloudwatch/ec2_cpu_utilization_77c1ca.csv,0.512734098949,0.7463242280495985,2,3022,3,401,3428
numentaTM,standard,realAWSCloudwatch/ec2_cpu_utilization_825cc2.csv,0.512734098949,0.8465378402835625,7,3084,1,336,3428
numentaTM,standard,realAWSCloudwatch/ec2_cpu_utilization_ac20cd.csv,0.512734098949,0.8741249559990424,3,3025,0,400,3428
numentaTM,standard,realAWSCloudwatch/ec2_cpu_utilization_c6585a.csv,0.512734098949,-1.3200000000000003,0,3416,12,0,3428
numentaTM,standard,realAWSCloudwatch/ec2_cpu_utilization_fe7f93.csv,0.512734098949,0.7396346345610598,2,3023,0,403,3428
numentaTM,standard,realAWSCloudwatch/ec2_disk_write_bytes_1ef3de.csv,0.512734098949,0.4503643853288792,2,3544,4,471,4021
numentaTM,standard,realAWSCloudwatch/ec2_disk_write_bytes_c0d644.csv,0.512734098949,0.572344793759493,9,3020,3,396,3428
numentaTM,standard,realAWSCloudwatch/ec2_network_in_257a54.csv,0.512734098949,0.8606718242697022,4,3025,0,399,3428
numentaTM,standard,realAWSCloudwatch/ec2_network_in_5abac7.csv,0.512734098949,1.392569846650011,3,3544,3,471,4021
numentaTM,standard,realAWSCloudwatch/elb_request_count_8c0756.csv,0.512734098949,1.2373550178968689,6,3021,5,396,3428
numentaTM,standard,realAWSCloudwatch/grok_asg_anomaly.csv,0.512734098949,2.3785084295289582,6,3460,3,459,3928
numentaTM,standard,realAWSCloudwatch/iio_us-east-1_i-a2eb1cd9_NetworkIn.csv,0.512734098949,-2.1100000000000003,0,930,1,126,1057
numentaTM,standard,realAWSCloudwatch/rds_cpu_utilization_cc0c53.csv,0.512734098949,-0.13844919792440225,2,3026,0,400,3428
numentaTM,standard,realAWSCloudwatch/rds_cpu_utilization_e47b3b.csv,0.512734098949,1.7122692801414665,3,3026,0,399,3428
numentaTM,standard,realKnownCause/ambient_temperature_system_failure.csv,0.512734098949,1.1097728415896388,4,5785,6,722,6517
numentaTM,standard,realKnownCause/cpu_utilization_asg_misconfiguration.csv,0.512734098949,-0.5733536752210493,18,15787,14,1481,17300
numentaTM,standard,realKnownCause/ec2_request_latency_system_failure.csv,0.512734098949,1.7058690538429593,7,3079,3,339,3428
numentaTM,standard,realKnownCause/machine_temperature_system_failure.csv,0.512734098949,1.5799660380277045,5,19665,12,2263,21945
numentaTM,standard,realKnownCause/nyc_taxi.csv,0.512734098949,0.5811362309810963,4,8535,0,1031,9570
numentaTM,standard,realKnownCause/rogue_agent_key_hold.csv,0.512734098949,-2.2199999999999998,0,1408,2,190,1600
numentaTM,standard,realKnownCause/rogue_agent_key_updown.csv,0.512734098949,-2.4493523667330703,0,4030,5,530,4565
numentaTM,standard,realTraffic/occupancy_6005.csv,0.512734098949,0.8612724903753929,3,1784,0,236,2023
numentaTM,standard,realTraffic/occupancy_t4013.csv,0.512734098949,1.6260251845026104,5,1874,1,245,2125
numentaTM,standard,realTraffic/speed_6005.csv,0.512734098949,0.2926220017559382,4,1881,5,235,2125
numentaTM,standard,realTraffic/speed_7578.csv,0.512734098949,3.348009838874456,6,840,2,110,958
numentaTM,standard,realTraffic/speed_t4013.csv,0.512734098949,1.9846249146536796,8,1871,0,242,2121
numentaTM,standard,realTraffic/TravelTime_387.csv,0.512734098949,0.4818139803256516,2,1875,1,247,2125
numentaTM,standard,realTraffic/TravelTime_451.csv,0.512734098949,-1.0,0,1621,0,217,1838
numentaTM,standard,realTweets/Twitter_volume_AAPL.csv,0.512734098949,1.3231743201283557,10,13558,6,1578,15152
numentaTM,standard,realTweets/Twitter_volume_AMZN.csv,0.512734098949,-0.8539571446632515,7,13495,6,1573,15081
numentaTM,standard,realTweets/Twitter_volume_CRM.csv,0.512734098949,0.723575559502073,5,13559,0,1588,15152
numentaTM,standard,realTweets/Twitter_volume_CVS.csv,0.512734098949,2.379692574960263,8,13574,3,1518,15103
numentaTM,standard,realTweets/Twitter_volume_FB.csv,0.512734098949,1.5004822217234075,3,13499,2,1579,15083
numentaTM,standard,realTweets/Twitter_volume_GOOG.csv,0.512734098949,-0.2601961746978674,8,13650,10,1424,15092
numentaTM,standard,realTweets/Twitter_volume_IBM.csv,0.512734098949,-0.992259751590564,6,13527,26,1584,15143
numentaTM,standard,realTweets/Twitter_volume_KO.csv,0.512734098949,2.3539022048077136,5,13511,3,1582,15101
numentaTM,standard,realTweets/Twitter_volume_PFE.csv,0.512734098949,1.0223089237272216,10,13512,8,1578,15108
numentaTM,standard,realTweets/Twitter_volume_UPS.csv,0.512734098949,1.099002109602106,19,13518,13,1566,15116
Totals,,,,33.87024468058447,251,299155,192,33244,332842
