Detector,Profile,File,Threshold,Score,TP,TN,FP,FN,Total_Count
numentaTM,reward_low_FN_rate,artificialNoAnomaly/art_daily_no_noise.csv,0.49424913259099995,0.0,0,3428,0,0,3428
numentaTM,reward_low_FN_rate,artificialNoAnomaly/art_daily_perfect_square_wave.csv,0.49424913259099995,0.0,0,3428,0,0,3428
numentaTM,reward_low_FN_rate,artificialNoAnomaly/art_daily_small_noise.csv,0.49424913259099995,0.0,0,3428,0,0,3428
numentaTM,reward_low_FN_rate,artificialNoAnomaly/art_flatline.csv,0.49424913259099995,0.0,0,3428,0,0,3428
numentaTM,reward_low_FN_rate,artificialNoAnomaly/art_noisy.csv,0.49424913259099995,0.0,0,3428,0,0,3428
numentaTM,reward_low_FN_rate,artificialWithAnomaly/art_daily_flatmiddle.csv,0.49424913259099995,0.8571268814503882,6,3025,0,397,3428
numentaTM,reward_low_FN_rate,artificialWithAnomaly/art_daily_jumpsdown.csv,0.49424913259099995,0.8553262996215624,1,3025,0,402,3428
numentaTM,reward_low_FN_rate,artificialWithAnomaly/art_daily_jumpsup.csv,0.49424913259099995,0.8606718242697022,5,3025,0,398,3428
numentaTM,reward_low_FN_rate,artificialWithAnomaly/art_daily_nojump.csv,0.49424913259099995,-2.093690827631788,0,3024,1,403,3428
numentaTM,reward_low_FN_rate,artificialWithAnomaly/art_increase_spike_density.csv,0.49424913259099995,-2.33,0,3022,3,403,3428
numentaTM,reward_low_FN_rate,artificialWithAnomaly/art_load_balancer_spikes.csv,0.49424913259099995,0.515492147479458,37,3021,4,366,3428
numentaTM,reward_low_FN_rate,realAdExchange/exchange-2_cpc_results.csv,0.49424913259099995,-2.0,0,1218,0,163,1381
numentaTM,reward_low_FN_rate,realAdExchange/exchange-2_cpm_results.csv,0.49424913259099995,1.6182433060422161,3,1218,1,159,1381
numentaTM,reward_low_FN_rate,realAdExchange/exchange-3_cpc_results.csv,0.49424913259099995,2.5543675566580184,3,1155,0,150,1308
numentaTM,reward_low_FN_rate,realAdExchange/exchange-3_cpm_results.csv,0.49424913259099995,0.7521595533438323,1,1154,1,152,1308
numentaTM,reward_low_FN_rate,realAdExchange/exchange-4_cpc_results.csv,0.49424913259099995,-0.7074614030380557,5,1228,4,160,1397
numentaTM,reward_low_FN_rate,realAdExchange/exchange-4_cpm_results.csv,0.49424913259099995,0.3847103626849764,6,1231,2,158,1397
numentaTM,reward_low_FN_rate,realAWSCloudwatch/ec2_cpu_utilization_24ae8d.csv,0.49424913259099995,0.5887849436245678,4,3015,11,398,3428
numentaTM,reward_low_FN_rate,realAWSCloudwatch/ec2_cpu_utilization_53ea38.csv,0.49424913259099995,1.095025016909685,7,3021,5,395,3428
numentaTM,reward_low_FN_rate,realAWSCloudwatch/ec2_cpu_utilization_5f5533.csv,0.49424913259099995,1.7231016041511955,6,3026,0,396,3428
numentaTM,reward_low_FN_rate,realAWSCloudwatch/ec2_cpu_utilization_77c1ca.csv,0.49424913259099995,0.7463242280495985,2,3022,3,401,3428
numentaTM,reward_low_FN_rate,realAWSCloudwatch/ec2_cpu_utilization_825cc2.csv,0.49424913259099995,0.8465378402835625,7,3084,1,336,3428
numentaTM,reward_low_FN_rate,realAWSCloudwatch/ec2_cpu_utilization_ac20cd.csv,0.49424913259099995,0.8741249559990424,3,3025,0,400,3428
numentaTM,reward_low_FN_rate,realAWSCloudwatch/ec2_cpu_utilization_c6585a.csv,0.49424913259099995,-1.3200000000000003,0,3416,12,0,3428
numentaTM,reward_low_FN_rate,realAWSCloudwatch/ec2_cpu_utilization_fe7f93.csv,0.49424913259099995,-0.2603653654389402,2,3023,0,403,3428
numentaTM,reward_low_FN_rate,realAWSCloudwatch/ec2_disk_write_bytes_1ef3de.csv,0.49424913259099995,0.4503643853288792,2,3544,4,471,4021
numentaTM,reward_low_FN_rate,realAWSCloudwatch/ec2_disk_write_bytes_c0d644.csv,0.49424913259099995,-0.523625659809962,11,3019,4,394,3428
numentaTM,reward_low_FN_rate,realAWSCloudwatch/ec2_network_in_257a54.csv,0.49424913259099995,0.8606718242697022,4,3025,0,399,3428
numentaTM,reward_low_FN_rate,realAWSCloudwatch/ec2_network_in_5abac7.csv,0.49424913259099995,1.392569846650011,3,3544,3,471,4021
numentaTM,reward_low_FN_rate,realAWSCloudwatch/elb_request_count_8c0756.csv,0.49424913259099995,1.2373550178968689,6,3021,5,396,3428
numentaTM,reward_low_FN_rate,realAWSCloudwatch/grok_asg_anomaly.csv,0.49424913259099995,2.3785084295289582,6,3460,3,459,3928
numentaTM,reward_low_FN_rate,realAWSCloudwatch/iio_us-east-1_i-a2eb1cd9_NetworkIn.csv,0.49424913259099995,-4.109999999999999,0,930,1,126,1057
numentaTM,reward_low_FN_rate,realAWSCloudwatch/rds_cpu_utilization_cc0c53.csv,0.49424913259099995,-1.1384491979244022,2,3026,0,400,3428
numentaTM,reward_low_FN_rate,realAWSCloudwatch/rds_cpu_utilization_e47b3b.csv,0.49424913259099995,1.7122692801414665,3,3026,0,399,3428
numentaTM,reward_low_FN_rate,realKnownCause/ambient_temperature_system_failure.csv,0.49424913259099995,1.1097728415896388,5,5785,6,721,6517
numentaTM,reward_low_FN_rate,realKnownCause/cpu_utilization_asg_misconfiguration.csv,0.49424913259099995,-0.5732010331259805,24,15787,14,1475,17300
numentaTM,reward_low_FN_rate,realKnownCause/ec2_request_latency_system_failure.csv,0.49424913259099995,1.7058690538429593,7,3079,3,339,3428
numentaTM,reward_low_FN_rate,realKnownCause/machine_temperature_system_failure.csv,0.49424913259099995,1.2499660380277042,5,19662,15,2263,21945
numentaTM,reward_low_FN_rate,realKnownCause/nyc_taxi.csv,0.49424913259099995,-1.4188637690189037,5,8535,0,1030,9570
numentaTM,reward_low_FN_rate,realKnownCause/rogue_agent_key_hold.csv,0.49424913259099995,-4.220000000000001,0,1408,2,190,1600
numentaTM,reward_low_FN_rate,realKnownCause/rogue_agent_key_updown.csv,0.49424913259099995,-2.0757598281380347,9,4030,5,521,4565
numentaTM,reward_low_FN_rate,realTraffic/occupancy_6005.csv,0.49424913259099995,0.8612724903753929,3,1784,0,236,2023
numentaTM,reward_low_FN_rate,realTraffic/occupancy_t4013.csv,0.49424913259099995,1.6260251845026104,5,1874,1,245,2125
numentaTM,reward_low_FN_rate,realTraffic/speed_6005.csv,0.49424913259099995,0.2926220017559382,4,1881,5,235,2125
numentaTM,reward_low_FN_rate,realTraffic/speed_7578.csv,0.49424913259099995,3.2384337205003875,6,839,3,110,958
numentaTM,reward_low_FN_rate,realTraffic/speed_t4013.csv,0.49424913259099995,1.9846249146536796,9,1871,0,241,2121
numentaTM,reward_low_FN_rate,realTraffic/TravelTime_387.csv,0.49424913259099995,-0.5181860196743484,2,1875,1,247,2125
numentaTM,reward_low_FN_rate,realTraffic/TravelTime_451.csv,0.49424913259099995,-2.0,0,1621,0,217,1838
numentaTM,reward_low_FN_rate,realTweets/Twitter_volume_AAPL.csv,0.49424913259099995,0.10317432012835548,10,13556,8,1578,15152
numentaTM,reward_low_FN_rate,realTweets/Twitter_volume_AMZN.csv,0.49424913259099995,-2.8539571446632515,7,13495,6,1573,15081
numentaTM,reward_low_FN_rate,realTweets/Twitter_volume_CRM.csv,0.49424913259099995,-0.276424440497927,5,13559,0,1588,15152
numentaTM,reward_low_FN_rate,realTweets/Twitter_volume_CVS.csv,0.49424913259099995,2.379692574960263,8,13574,3,1518,15103
numentaTM,reward_low_FN_rate,realTweets/Twitter_volume_FB.csv,0.49424913259099995,1.5004822217234075,3,13499,2,1579,15083
numentaTM,reward_low_FN_rate,realTweets/Twitter_volume_GOOG.csv,0.49424913259099995,-1.2601961746978674,8,13650,10,1424,15092
numentaTM,reward_low_FN_rate,realTweets/Twitter_volume_IBM.csv,0.49424913259099995,-1.3222597515905636,6,13524,29,1584,15143
numentaTM,reward_low_FN_rate,realTweets/Twitter_volume_KO.csv,0.49424913259099995,2.3539022048077136,5,13511,3,1582,15101
numentaTM,reward_low_FN_rate,realTweets/Twitter_volume_PFE.csv,0.49424913259099995,-0.08769107627277828,10,13511,9,1578,15108
numentaTM,reward_low_FN_rate,realTweets/Twitter_volume_UPS.csv,0.49424913259099995,0.09900210960210609,24,13518,13,1561,15116
Totals,,,,9.718443289331042,305,299141,206,33190,332842
